# key	value	pos
あそうわん	浅海湾	地名
いとしの	愛し野	地名
いりなか	杁中	地名
うとろ	宇登呂	地名
うらしべつ	浦士別	地名
えとんびやま	江鳶山	地名
えんけい	燕京	地名
おんねない	音根内	地名
おんねべつ	遠音別	地名
かっくみ	活汲	地名
ききん	木禽	地名
さきむい	崎無異	地名
しんせん	深圳	地名
たごうら	田子浦	地名
たちあらい	太刀洗	地名
ちえんべつ	知円別	地名
とっぷし	富武士	地名
とどがさき	魹ヶ崎	地名
ねぶたに	掖谷	地名
ひかりの	ひかり野	地名
みどり	美禽	地名
みぬめ	敏馬	地名
みるめ	敏馬	地名
